R 1200 800

NO ./textures/wood.xpm
SO ./textures/bluestone.xpm
WE ./textures/purplestone.xpm
EA ./textures/eagle.xpm
S ./textures/sprite_1.xpm

F 30,30,30
C 45,250,250

1 1 1 1 1 1 1 1 1 1 1 1 1 1 1 1 1 1
1 0 0 0 0 0 0 0 0 0 0 0 0 0 0 0 2 1
1 0 0 1 0 0 1 0 1 1 0 1 0 0 0 0 0 1
1 0 1 0 0 W 0 0 0 0 0 1 2 0 2 0 2 1
1 1 0 0 0 0 0 0 0 1 0 1 1 1 1 1 1 1
1 0 1 0 1 0 1 0 1 0 0 1 1 1 1 1 1 1
1 0 0 0 0 0 0 0 0 0 0 1 1 1 1 1 1 1
1 1 1 1 1 1 1 1 1 1 1 1 1 1 1 1 1 1
