R 1920 1080

NO ./textures/wood.xpm
SO ./textures/wall_4.xpm
WE ./textures/wall_3.xpm
EA ./textures/eagle.xpm
S ./textures/sprite_1.xpm

F 30,30,30
C 250,250,250

1 1 1 1 1 1 1 1 1 1 1 1
1 0 0 0 0 0 0 0 0 0 0 1
1 0 0 0 0 0 0 0 0 0 0 1
1 0 0 0 0 W 0 0 0 0 0 1
1 0 0 0 0 0 0 0 0 0 0 1
1 0 0 0 0 0 0 0 0 0 0 1
1 0 0 0 0 0 0 0 0 0 0 1
1 1 1 1 1 1 1 1 1 1 1 1