R 800 600

NO ./Texture_Wolf/textureXPM/wall_wood.xpm
SO ./Texture_Wolf/textureXPM/wall_eagle_nazis.xpm
WE ./Texture_Wolf/textureXPM/wall_eagle_nazis.xpm
EA ./Texture_Wolf/textureXPM/wall_eagle_nazis.xpm
S ./Texture_Wolf/textureXPM/object_health.xpm

F 160,160,160
C 60,60,60

1111111111111
10A010S011111
1400100011111
1000100011111
1151115111a11
1000100010001
1200500050021
1000104010001
1111115111111
1111111111111